NO ./asset/textures/wall_n.xpm
SO ./asset/textures/wall_s.xpm
EA .efneoif
C 225,30,0
WE ./asset/textures/wall_w.xpm
F 220,100,0

1111111
11N111
111111111111
111111111111