
NO      ./textures/eagle.xpm
SO ./textures/greystone.xpm
WE ./textures/purplestone.xpm
EA ./textures/red.xpm
C   

F , 000 0 

                        1111
                1111   1   1
        1111    1111    1  1
        1000    1001       1	
    111110011111100111111  11111
11110000000000000000000000000001111


1100000000000000000000000000000111111111
11000000000000000000000000000000000000001
11000000000000000000000000000001000011111
1100000000000   0000000000000001
1100000000000   0000000000000001
1100000000000   0000000000000001
1100000000000000000000000000000110111
11000000000000000000000000000000000011
11111000000000000000000000000001111111
    1111000111111001111110011111
        1001    1001    1001
        1001    1001    1001
        1111    1111    1111