1111111111111111111
1000V10C00000100001
1C10000000000000001
10000C0000V00000001
10010V00001000000C1
10C1100000000100EP1
1111111111111111111
