111111111111111
100001000000001
1P00E11000000C1
1CCCCCCCCCCCCC1
111111111111111
